11
111100000000000
111111000000000
111111111000000
111111100000000
111111100000000
111111111000000
111111111000000
111111110100000
111111110100000
111111111110000
111111110110000
111111111110000
111111111111100
111111111111010
111111111111110
111111111111111
111111111111111
111111111111111
111111111111111
111111111111111
11